21 21
 *                   
 * ***** ***** ***** 
 *     * *     *   * 
 ***** * * ***** * * 
 *   * *           * 
 * * * *** ******* * 
 *   *   *   *       
 * *** * * * * *** **
 * *   *   * *   *   
 * * * * ******* *** 
 *   *       *   *   
 *** *** ***** * * **
   * *   *       *   
** * * *** *** ***** 
     *   * *   *   * 
 ******* * * *** * * 
 *     * *       * * 
 * *** * ***** *** * 
     *   *  /*   */* 
 *** * *** *** * *** 
           *   *     
