15 17
 *   */  * * * * 
 *** *** * * * * 
 * * * * *   *   
 * * * * * *** **
   *      *      
 * * * * *** ****
 *   * *   *     
 *** ***** *** **
 *   *     *     
******** *** ****
                 
**** * * * * * * 
     * * * * * * 
** ******* * * * 
   *       * */* 
