27 27
 *   *         *       *   
 *** * ******* * ***** * * 
     *   * * * * *   * * * 
**** ***** * * * *** * *** 
     *   *   * *     * *   
**** * * *** * ******* * * 
     * *       *         * 
 *** *** ***** * *** ***** 
 * *     *   * * * * *   * 
 * ******* *** * * * * ****
   *     *     *   *   *   
 * * * *** ***** * * * * **
 * * *   * *     * * *     
 * * *** * ********* ******
 * * * * *         *     * 
 * * * *   ******* ***** * 
 * *** *****     * *   *   
 *         * *** * *** *** 
 *** * *   *   * *       * 
 *   * ********* * ***** * 
 * ***     *   * * *  /* * 
 * * ***** * * *   * *** **
   * *   *   * * * *       
**** * * * * * * * ********
       * * * *   *         
 ******* *** ** **** **** *
      /*     *   *     *  /
